[
	[0,  0,  -2,  100,  0,  0,  -1,  -1,  -3,  0,  0,  0,  -1,  -1,  0,  0,  -3,  0,  -1,  -1,0],
	[-1,-1,  -2,  0, 0,  0,  -3,  -1,  0,  -2,  0,  0,  0,  -1,  0,  -1,  0,  -2,  -1,  0,0],
	[0,  0,  -1,  0,  0,  0,  0,  -1,  -1,  -1,  0, 0,  100,  0,  0,  0,  0,  50,  -2,  0,0],
	[0,  0,  0,  0,  -2,  0,  0,  0,  0,  0,  0,  0,  -1,  50, -2,  0,  0,  -1,  -1,  0,0],
	[-2, 0,  200,  -2,  -2,  300,  0, 0,  -2,  -2,  0,  0,  -3,  0,  -1,  0,  0,  -3,  -1,  0,0],
	[0,  -1,  0,  0,  0,  0,  0,  -3,  0,  0,  -1,  -1,  0,  0,  0,  0,  0,  0,  -2,  0,0],
	[0,  -1,  -1,  0,  0,  -1,  -1,  0,  0,  700,  -1,  0,  0,  0,  -2,  -1,  -1,  0,  0, 0,100],
	[0,  0, 0, 500,  0,  0,  -1,  0,  -2,  -2,  -1,  -1,  0,  0,  -2,  0,  -3,  0,  0,  -1,0],
	[-1,  -1, 0,-2 ,  0,  -1,  -2,  0,  400,  -2,  -1,  -1,  500,  0,  -2,  0,  -3,  100,  0, 0,0]

]
