[
	[0,  0,  -2,  0,  100,  0,  -1,  -1,  -3,  0,  0,  0,  -1,  -1,  0,  0,  -3,  0,  -1,  -1,0],
	[-1,-1,  -2,  0, 0,  0,  -3,  -1,  0,  -2,  100,  0,  0,  -1,  0,  -1,  0,  -2,  -1,  0,0],
	[0,  0,  -1,  0,  0,  0,  0,  -1,  -1,  -1,  0, 0,  0,  0,  50,  0,  0,  0,  -2,  0,0],
	[0,  200,  0,  0,  -2,  0,  0,  0,  0,  0,  0,  0,  -1,  0, -2,  0,  50,  -1,  -1,  0,0],
	[-2, 0,  0,  -2,  -2,  0,  0, 0,  -2,  -2,  0,  0,  -3,  0,  -1,  0,  0,  -3,  -1,  0,0],
	[0,  -1,  0,  0,  300,  0,  0,  -3,  0,  0,  -1,  -1,  0,  0,  0,  0,  0,  0,  -2,  0,0],
	[500,  -1,  -1,  0,  0,  -1,  -1,  0,  0,  700,  -1,  0,  0,  0,  -2,  -1,  -1,  0,  0, 100,0],
	[0,  0, 0, 0,  0,  0,  -1,  0,  -2,  -2,  -1,  -1,  0,  0,  -2,  0,  -3,  0,  0,  -1,0],
	[-1,  -1, 0,-2 ,  0,  -1,  -2,  400,  0,  -2,  -1,  -1,  0,  500,  -2,  0,  -3,  0,  0, 100,0]

]
